1111111
1E00001
10P11C1
1111111