1111111
1E000001
100000P1
1111111