11111111111111111
1P01000010C111111
11000000000000001
111011111110E0001
10C00100001000001
11111111111111111